TILEMAP
11 4					-- Size of tile map in tiles
4 3                                     -- levels
32 63 							-- Tile size
64 64                                                   -- Block size
tails/xxx.png 	-- Tilesheet
8 8			-- Number of tiles in tilesheet
XXXXXXXX22222211XXXXX11111111111111311111
T4B4RPRRR111RRRRRRRRX11111111111111311111
T134RHFRR222222RR222211113111111111311111
T2444XT4RXT223222222111111111111111311111
T2121RR1ERRRRRRRRRRR111113111111111311111
T41212RRT2221111R122211111111111111311111
T2444RR4C22222222222211111111111111311111
T2121RR1ERRRRRRRRRRRX11111111111111311111
T33212RRT2221111R122111113111111111311111
T2444222C22222222222X11111111111111311111