TILEMAP
11 4					-- Size of tile map in tiles
6 5                                     -- levels
32 63 							-- Tile size
64 64                                                   -- Block size
tails/xxx.png 	-- Tilesheet
8 8			-- Number of tiles in tilesheet
T44444444444444444444444444444444444444444444444444444444444T
T143E946142416ERR2B443FRRR46614DERRR2rXWWWWWWWWWWWWWWWWWWWWWT
XWWWVRXWWWWWWWVR2XWWWWTRRRXWWWWWVRR236123142FRRR4344619R6aXWT
Ta123461431D6632XWWWWWTRRRT961DBPR4PRRaXWWWWTRRRXWTC2242XWWWT
TCa6312MRXWWWWWWWWWWWWTRRRT53CXTP4RPRR3XWWWWTRRRXWWWWWWWWWWWT
TR6434234XWWWWWWWWWWWWTRRRXT4212PRRP4R31466rTRRRXWWWWWWWWWWWT
T5343124rXWWWWWWWWWWWWT555XTa31RP4R34R3XWWWWTRRRXWWWWWWWWWWWT
XWWWWWWWWWWWWWWWWWWWWT2321644342PRRHRR3XWWWWTRRRXWWWWWWWWWWWT
XWWWWWWWWWWWWWWWTC64214316244344PR4TRR3XWWWWT555XWWWWWWWWWWWT
XWWWWWWWWWWWWWWWTa61242346212322354TER3124rXWWWWWWWWWWWWWWWWT
Tr6ERRRFRERR3FRR26312ERRRFR621ERRXWWURXWWWWWWWWWWWWWWWWWWWWWT
XWWTRRRTRTRRXTRRXWWWWTRRRTRXWWTR2CT625WWWWWWWWWWWWWWWWWWWWWWT
XWWTRRRTRTRRXTRRXWWWWTRRRTRXWWT4366666144234126M9XWWWWWWWWWWT
XWWTRRRTRTRRXTRRXWWWWTRRRTRXWWWWWWWWWWWWWT9412435XWTRRRRRRRXT
XWWTRRRTRTRRXTRRXWWWWTRRRTRXWWWWWWWWWWWWWT4D146PRXWVRRRRRRRXT
XWWT555T5T55XT55XWWWWT555T5XWWWWWWWWWWWWWTC612232B234122214XT
